*****************************************
*   *       *     *           *         *
* * * *** * * *** * ******* *** ******* *
* *S*   * *   *   * *     *           * *
* ***** * ********* * * ************* * *
* *     * *         * *       *   *   * *
* * ***** * ********* ***** * * * * *** *
* *     *   *     *     *   * * * * * * *
* ***** ********* * ***** *** * * * * * *
*   *           *   *     *   * * *   * *
* *** ********* * *** ***** *** * ***** *
*   *   *     * * *   *       * *       *
* * *** * *** * *** *** ******* ******* *
* *     * *   *     *   * *     *     * *
* ******* * *********** * * ***** * *** *
*     * * *   *       *   * *   * *     *
***** * ***** * ***** *** * *** * *******
*   * *     * *   *   *   * *   *     * *
* *** *** *** *** * *** *** * ******* * *
*   *     *   *   * *   *   * *     *   *
*** ***** * *** *** *** * *** * *** *** *
*       * *   * * *   * * *   * * *     *
* ******* *** * * *** *** * *** * *******
*       *   *   *   * *   *     *       *
* ***** *** ***** * * * ***** *** *** ***
*   * * *   *     * * *     * *     *   *
*** * * * *** * ***** * *** * * ******* *
* *   *   *   * *     *   * * * *     * *
* *** ***** *** * ***** *** * * * *** * *
*   *       *   * * *   *   * * *   *   *
* * ********* *** * * *** *** * *** *****
* *     *   * * * *   *   * * *   *     *
* ***** * * * * * *** * *** * ********* *
* *   * * * * * *   * *   *             *
* * * * * * * * *** *** * ************* *
* * *     * * *   *   * *       *       *
* ********* * * * *** *** ***** * *******
*     *     * * *   *   * *     * *     *
* *** ******* *** * *** *** ***** * *** *
*   *             *   *     *       *E  *
*****************************************