***************
*S        *   *
*** *** *** * *
*   *   *   * *
* ***** ***** *
*     *   *   *
* *** * *** ***
* *   * *   * *
* * *** * *** *
* * * * * *   *
*** * * * * * *
*   *   * * * *
* ******* * * *
*           *E*
***************