****************
*         *   E*
*    *    * ****
*    ******    *
*    *    *    *
*    *    *    *
*S   *         *
****************
