******
* E  *
*    *
*S   *
******
